##########
#S..#....#
#.#.#.##.#
#.#...#..#
#.###.#.##
#...#.#..#
###.#.#.##
#...#.#..#
#.#.#.#E.#
##########